90
0
13
5
3
0
2
2
+F+X+F+C+
FXTXTXFXT
+F+C+F+T+
TXTXXXTXF
+F+F+F+T+